AboutDialogText=Jake, eine Plattform für Zusammenarbeit

LoginDialogInvalidLoginText=Die Anmeldedaten waren nicht richtig. Versuche es erneut.
LoginDialogInvalidLoginTitle=Anmeldefehler

NetworkError=Ein Netzwerkfehler ist aufgetreten. Der Fehler ist: %0%
LoginUseridNotValid=Das Format der userid, der eingegeben wurde, ist nicht gültig, oder der User existiert nicht.

PreferencesWindowTitle=Einstellungen
PreferencesLabelShowOfflineProjectMembers=Abgemeldete Projektmitglieder anzeigen
PreferencesLabelAutoRefresh=Automatisches aktualisieren der Ansicht aktivieren
PreferencesLabelAutoPush=Auto-Push aktivieren
PreferencesLabelAutoPull=Auto-Pull aktivieren
PreferencesLabelAutoLogSync=Intervall für automatische Aktualisierung (sec)
PreferencesLabelUserName=Benutzername
PreferencesLabelPassword=Passwort
PreferencesInvalidUserIdError=Ungültige userid. Die userid muss von der Form foo@bar.com sein.

ButtonConfirm=OK
ButtonCancel=Abbrechen
ButtonClose=Schließen

NewProjectDialogTitle=Jake - eine Plattform für Zusammenarbeit
NewProjectDialogInfo=<html><body>Jake ist eine Plattform für Zusammenarbeit.<br>Das gemeinsame Arbeiten an Dateien beginnt mit drei Schritten: </body></html>
NewProjectDialogAdviseSelectFolder=1. Arbeitsordner wählen
NewProjectDialogFolder=Ordner:
NewProjectDialogAdviseNameProject=2. Das Projekt benennen
NewProjectDialogProjectName=Projektname:
NewProjectDialogAdviseUserid=3. Die userid für den %0% Service eingeben:
NewProjectDialogUserid=Userid:
NewProjectDialogOpenProject=Projekt öffnen
NewProjectDialogCreateProject=Projekt erstellen
NewProjectDialogCreateOpenProject=Projekt erstellen/öffnen
NewProjectDialogInvalidDatabase=Ungültige Datenbank
NewProjectDialogInvalidRootPath=Ungültiger Projektordner
NewProjectDialogProjectNameTooShort=Der Projektname ist zu kurz
NewProjectDialogInvalidUserIdFormat=Die eingegebene userid ist ungültig.
NewProjectDialogProjectAlreadyExists=Das Projekt existiert bereits
NewProjectDialogInvalidProjectDirectory=Der Projektordner ist ungültig
NewProjectDialogFolderLabel=Ordner
NewProjectDialogFolderSelectButton=...


MenuNetwork=Netzwerk
MenuItemSignIn=Anmelden ...
MenuItemSignOut=Abmelden

MenuFile=Datei
MenuItemPreferences=Einstellungen...
MenuItemQuit=Beenden

MenuView=Ansicht
MenuItemPeople=Leute
MenuItemFiles=Dateien
MenuItemNotes=Notizen
MenuItemLog=Projekt-Protokoll

MenuProject=Projekt
MenuItemOpenProjectFolder=Projektordner öffnen
MenuItemNewNote=Neue Notiz...
MenuItemRefreshDatapoolView=Datenpool aktualisieren
MenuItemAddFile=Datei hinzufügen...
MenuItemAddFolder=Ordner hinzufügen...
MenuItemAddProjectMember=Projektmitglied hinzufügen...

MenuHelp=Hilfe
MenuItemAbout=Über Jake ...

SearchMenuItemName=Name
SearchMenuItemTags=Tags
SearchMenuItemBoth=Beides

FilesPanelDialogConfirmDeleteDialogTitle=Datei löschen?
FilesPanelDialogConfirmDeleteDialogText=Bist du sicher, dass du die folgende Datei unwiderruflich löschen willst? <br /> %0%
FilesPanelDialogFileDeletedTitle=Datei gelöscht
FilesPanelDialogFileDeletedText=Die Datei %0% wurde gelöscht!
FilesPanelDialogFileNotDeletedTitle=Datei nicht gelöscht
FilesPanelDialogFileNotDeletedText=Die folgende Datei konnte nicht gelöscht werden. Vielleicht stimmen die Rechte nicht. <br/> %0%
FilesPanelDialogCouldNotLaunchFiledTitle=Datei könnte nicht geöffnet werden
FilesPanelDialogCouldNotLaunchFileInvalidText=Die Datei scheint ungültig zu sein.
FilesPanelDialogCouldNotLaunchFileOpenText=Das Betriebssystem hat dieser Datei vermutlich keine Applikation zugewiesen.
FilesPanelDialogCouldNotLaunchFileNoProjectText=Datei konnte nicht geöffnet werden, da kein Projekt geladen ist.
FilesPanelDialogCouldNotLaunchFileIOText=Beim Öffnen der Datei trat ein IO-Fehler auf.
FilesPanelDialogImportFailedTitle=Importieren fehlgeschlagen
FilesPanelDialogImportFailedText=Die Datei %0% konnte nicht ins Projekt importiert werden, da sie entweder bereits im Projekt existiert, oder der Dateiname ungültig ist.
FilesPanelDialogImportSucceededTitle=Importieren erfolgreich
FilesPanelDialogImportSucceededText=Die Datei %0% wurde erfolgreich ins Projekt importiert.


FilesDialogContextMenuItemOpen=Öffnen
FilesDialogContextMenuItemSetLock=Sperre setzen...
FilesDialogContextMenuItemDeleteFile=Datei löschen
FilesDialogContextMenuItemViewLog=Protokoll anzeigen...
FilesDialogContextMenuItemResolveConflict=Konflikt lösen...
FilesDialogContextMenuItemPushFile=Dateiversion freigeben
FilesDialogContextMenuItemPullFile=Datei laden
FilesDialogContextMenuItemImportFile=Datei importieren

FilesTableModelColumnName=Name
FilesTableModelColumnSize=Größe
FilesTableModelColumnTags=Tags
FilesTableModelColumnSyncStatus=Synchronisationszustand
FilesTableModelColumnLastChanged=Letzte Änderung
FilesTableModelColumnUser=Benutzer
FilesTableModelFileNotInProject= <Datei nicht im Projekt>

NotesPanelDialogTitle=Notizen (%0%)
NotesPanelDialogCannotBeUndone=Dieser Vorgang kann nicht rückgängig gemacht werden.
NotesPanelDialogReallyDeleteNode=Willst du die Notiz wirklich löschen?
NotesPanelDialogMenuNewNote=Neue Notiz...
NotesPanelDialogMenuOpenNote=Notiz öffnen...
NotesPanelDialogMenuRemoveNote=Notiz löschen...

NotesTableModelColumnTitle=Titel
NotesTableModelColumnTags=Tags
NotesTableModelColumnLastChanged=Letzte Änderung
NotesTableModelColumnUser=Benutzer
NotesTableModelNoteNotInProject=<Notiz nicht im Project>

NoteEditorDialogNewNoteTitle=Neue Notiz
NoteEditorDialogEditNoteTitle=Notiz bearbeiten
NoteEditorDialogOkButton=Speichern

ConflictDialogTitle=Konflikt lösen
ConflictDialogUseLocalFile=Lokale Version verwenden
ConflictDialogUseRemoteFile=Fremdversion verwenden
ConflictDialogOpen=Öffnen
ConflictDialogLastEdit=Zuletzt bearbeitet
ConflictDialogLastEditor=Zuletzt bearbeitet von
ConflictDialogLocal=Lokal
ConflictDialogRemote=Fremd
ConflictDialogFileSize=Dateigröße
ConflictDialogOK=OK
ConflictDialogCancel=Abbrechen
ConflictDialogHeader=Konflikt lösen von

SetSoftLockDialogTitle=Sperre setzen
SetSoftLockDialogActivateLabel=Sperre aktivieren
SetSoftLockDialogOverrideLockButton=Sperre überschreiben
SetSoftLockDialogLockedByLabel=Sperre wurde gesetzt von: 
SetSoftLockDialogLockedByYouLabel=Die Sperre wurde von dir selbst gesetzt.

MainToolbarToolTipSync=Datenpool mit anderen Projektmitgliedern synchronisieren
MainToolbarToolTipPushFile=Dateiversionen der lokal bearbeiteten Dateien freigeben
MainToolbarToolTipPull=Dateien von anderen Projektmitgliedern laden
MainToolbarToolTipSearch=Nach Dateien suchen
MainToolbarToolTipSearchField=Suchterm hier eingeben

AddProjectMemberDialogTitle=userid eingeben
AddProjectMemberDialogSaveButton=Speichern

ViewProjectMemberCommentDialogButtonSave=Speichern
ViewProjectMemberCommentDialogTitle=Lokalen Kommentar zu %0% eingeben

HumanReadableFileStatusConflict=Konflikt
HumanReadableFileStatusIsNewestVersion=Neueste Version
HumanReadableFileStatusNewerVersionAvailable=Neuere Version vorhanden
HumanReadableFileStatusLocallyChanged=Lokal bearbeitet
HumanReadableFileStatusLocalCopyExists=Lokal
HumanReadableFileStatusRemoteVersionExists=Verteilt
HumanReadableFileStatusNotInProject=Nicht im Projekt
HumanReadableFileStatusNotPushed=Keine Version freigegeben

ImportFileDialogSuccessMessageTitle=Importieren erfolgreich
ImportFileDialogSuccessMessageText=Die Datei wurde erfolgreich importiert
ImportFileDialogNotImportedMessageTitle=Importieren fehlgeschlagen
ImportFileDialogNotImportedMessageText=Die Datei %0% konnte nicht ins Projekt importiert werden, da sie entweder bereits im Projekt existiert, oder der Dateiname ungültig ist.
ImportFileDialogInvalidDirectoryMessageTitle=Invalid directory!
ImportFileDialogInvalidDirectoryMessageText=Du kannst nur einen Unterordner des Projektordners wählen.
ImportFileDialogDestinationFileChooserButton=Zielordner wählen
ImportFileDialogSourceFileChoosrButton=Ausgewählte Datei importieren
ImportFileDialogFileNotOutsideTitle=Zu importierende Datei schon im Projektordner
ImportFileDialogFileNotOutsideText=Die zu importierende Datei muss außerhalb des Projektordners sein
ImportFileDialogImportButton=Importieren
ImportFileDialogJakeIconLabel=Datei importieren
ImportFileDialogFileLabel=Quelldatei
ImportFileDialogBrowserFileButton=Wählen...
ImportFileDialogDestinationFolderLabel=Zielordner
ImportFileDialogDestinationFolderButton=Wählen...

JakeGuiStatusMessage=Jake ist gestartet und bereit ...

PeoplePanelTitle=Leute (%0%/%1%)
PeoplePanelMenuItemSendMessage=Nachricht senden...
PeoplePanelMenuItemShowInfo=Kommentar anzeigen...
PeoplePanelMenuItemAddProjectMember=Projektmitglied hinzufügen...
PeoplePanelMenuItemRemoveProjectMember=Projektmitglied entfernen

PeoplePanelDialogReallyDeletePerson=Projektmitglied wirklich löschen?
PeoplePanelDialogCannotBeUndone=Dieser Vorgang kann nicht rückgängig gemacht werden

PeopleTabelModelColumnNickname=Nickname
PeopleTabelModelColumnUserId=userid
PeopleTabelModelColumnStatus=Status
PeopleTabelModelStautsOnline=Online
PeopleTabelModelStatusOffline=Offline
PeopleTabelModelStatusNotLoggedIn=Anmelden um den Status zu sehen!
PeopleTabelModelStatusNoSuchUserId=User unbekannt

ReceiveMessageDialogTitle=Nachricht von %0%
ReceiveMessageDialogFromLabel=Von: 
ReceiveMessageDialogWhenLabel=Wann: 

SendMessageDialogMessageEmptyMessageText=Die Nachricht enthält keinen Text!
SendMessageDialogMessageEmptyMessageTitle=Leere Nachricht
SendMessageDialogMessageError=Fehler beim Senden
SendMessageDialogMessageRecipientDoesNotExistInProject=Der Empfänger ist kein Projektmitglied
SendMessageDialogMessageRecipientOffline=Der Empfänger ist derzeit offline. Versuche es später wieder.
SendMessageDialogMessageRecipientDoesNotExistInNetwork=Der Benutzeraccount des Empfänger ist unbekannt.
SendMessageDialogMessageNotLoggedIn=Die Nachricht konnte nicht gesendet werden, da du nicht online bist.
SendMessageDialogMessageGeneralNetworkError=Ein Netzwerkfehler ist aufgetreten, versuche es später wieder.
SendMessageDialogMessageSuccessText=Die Nachricht wurde erfolgreich an %0% versandt.
SendMessageDialogMessageSuccessTitle=Nachricht versandt
SendMessageDialogTitle=Nachricht senden
SendMessageDialogToLabel=An: 
SendMessageDialogSendButton=Senden

StatusPanelSingleMessageReceived=Eine Nachricht erhalten
StatusPanelMultipleMessagesReceived=%0% Nachrichten erhalten
StatusPanelSingleConflict=Dateikonflikt
StatusPanelMultipleConflicts=%0% Dateikonflikte
StatusPanelConnected=Angemeldet
StatusPanelConnectedToolTip=Angemeldet als %0%
StatusPanelNotConnected=Nicht angemeldet
StatusPanelNotConnectedTooltip=Zum anmelden klicken

ViewLogDialogTitle=Protokoll ansehen

ViewLogDialogTableModelColumnAction=Aktion
ViewLogDialogTableModelColumnUser=Benutzer
ViewLogDialogTableModelColumnTime=Zeit
ViewLogDialogTableModelColumnComment=Kommentar

ConsoleWelcome=Willkommen zu Jake - eine Plattform für Zusammenarbeit
NotLoggedInException=Du bist nicht angemeldet.
OtherUserOfflineException=Der andere Benutzer, der für diesen Vorgang benötigt wird, ist nicht online.
NotesDialogContextMenuItemSetLock=Sperre setzen...
ObjectNotInProject=Dieses Objekt wird nicht vom Projekt verwaltet
CommitMessage=Gib einen Kommentar ein, der deine Bearbeitung beschreibt. Er wird im Protokoll neben dem Datum und deinem Namen sichtbar sein.
SyncException=Beim Synchronisieren trat ein Fehler auf. Versuche es später erneut
PeopleTabTitle=Leute (%0%/%1%)
NotesTabTitle=Notizen (%0%)
FilesTabTitle=Dateien (%0%/%1%)

