AboutDialogText=Jake, a work in progress prototype...

LoginDialogInvalidLoginText=The login data you provided were invalid. Try again!
LoginDialogInvalidLoginTitle=Failed to log in

NetworkError=A network error occurred. The error was: %0%
LoginUseridNotValid=The user you entered doesn't exist or is of invalid format.

PreferencesWindowTitle=Preferences
PreferencesLabelShowOfflineProjectMembers=Show offline project members
PreferencesLabelAutoRefresh=Automatically refresh datapool view
PreferencesLabelAutoPush=activate auto push
PreferencesLabelAutoPull=activate auto pull
PreferencesLabelAutoLogSync=Auto update interval (sec)
PreferencesLabelUserName=User name
PreferencesLabelPassword=Password

ButtonConfirm=OK
ButtonCancel=Cancel
ButtonClose=Close

NewProjectDialogTitle=Jake - the collaborative file sharing client
NewProjectDialogInfo=<html><body>Jake is a collaborative file sharing client.<br>Begin sharing your files with three simple steps.</body></html>
NewProjectDialogAdviseSelectFolder=1. Select the folder you want to share:
NewProjectDialogFolder=Folder:
NewProjectDialogAdviseNameProject=2. Give your project a name! (or use folder name as default)
NewProjectDialogProjectName=Project Name:
NewProjectDialogAdviseUserid=3. Enter your userid for the %0% service
NewProjectDialogUserid=Userid:
NewProjectDialogOpenProject=Open Project
NewProjectDialogCreateProject=Create Project
NewProjectDialogCreateOpenProject=Create/Open Project

MenuNetwork=Network
MenuItemSignIn=Sign in...
MenuItemSignOut=Sign out

FilesPanelDialogConfirmDeleteDialogTitle=Delete file?
FilesPanelDialogConfirmDeleteDialogText=Are you sure you want to delete the following file? This action may not be undone. <br> %0%
FilesPanelDialogFileDeletedTitle=File deleted
FilesPanleDialogFileDeletedText=%0% has been deleted successfully!
FilesPanelDialogFileNotDeletedTitle=File not deleted
FilesPanelDialogFileNotDeletedText=The following file could not have been deleted from the project. Please make sure you have the necessary rights to perform this operation. <br> %0%

FilesDialogContextMenuItemOpen=Open
FilesDialogContextMenuItemSetLock=Set lock...
FilesDialogContextMenuItemDeleteFile=Delete file
FilesDialogContextMenuItemViewLog=View log...
FilesDialogContextMenuItemResolveConflict=Resolve conflict...
FilesDialogContextMenuItemPropagateFile=Propagate file
FilesDialogContextMenuItemPullFile=Pull file
FilesDialogContextMenuItemImportFile=Import file

FilesTableModelColumnName=Name
FilesTableModelColumnSize=Size
FilesTableModelColumnTags=Tags
FilesTableModelColumnSyncStatus=Sync status
FilesTableModelColumnLastChanged=Last changed
FilesTableModelColumnUser=User
FilesTableModelFileNotInProject= <file not in project>

ConflictDialogUseLocalFile=Use local File
ConflictDialogUseRemoteFile=Use remote file
ConflictDialogOpen=Open
ConflictDialogLastEdit=Last edited
ConflictDialogLastEditor=Last edited by
ConflictDialogLocal=Local
ConflictDialogRemote=Remote
ConflictDialogFileSize=File size
ConflictDialogOK=OK
ConflictDialogCancel=Cancel
ConflictDialogHeader=Resolve conflict in 

SetSoftLockDialogTitle=Set soft lock
SetSoftLockDialogActivateLabel=Activate soft lock
SetSoftLockDialogOverrideLockButton=Override lock
SetSoftLockDialogLockedByLabel=This lock was set by: 
SetSoftLockDialogLockedByYouLabel=This lock was set by: You

MainToolbarToolTipRefresh=Refresh datapool view
MainToolbarToolTipPropagateFile=Propagate locally changed files
MainToolbarToolTipPull=Pull files from project member
MainToolbarToolTipSearch=Search for files
MainToolbarToolTipSearchField=Enter search term here